TTGTBGGGGGBRGGBRGGRRRGRRRBGGGGGGBGGTTGRG
RTTGTGGBGTGBTTGGRRGGRGGRGGGBGGGGGGTTTGRG
TBGTGGGBTTTBBBBBBGRBGRGGGGRGGGTTGTTTTTGR
TGGBTTBGTTTGGTTRGGRGRBRGGGGGGTTTGTTTTTTG
BGGBBBBGRGGTBGGTGRGBGGRGGTGGTTTTTTTTGTGG
TGGGGGGGGBGBTGBGTTTBRRTGGGGGGTTTTTTTGTGG
TTGGTTGTGBBBTGGGGTBBGRGGGGGTTTTTTTTTTGGG
RTRGTTGTTGGTGGBGTTGTRTGGGGGGTTTTTTTTTGTG
WRTTTTTTTTGGGGGGGTTGBTBGGGGGGGGTGGTTTTGG
WRTTTTTTGGGTGGGGTTGTRGGGGGGGGGTGGTTTTTGR
WTRTTTBGTTTGGRTTTTTGGGGGGGGGGGGGGGGTGGTT
WWBRGGGGTTTTGGRTGGGGGGGGGGBGGGGGGGGGGGRR
WWRTTTGGGTTGGTGTGGGGGGGGGGBGGRGGGGGGRRGR
BWTGTTTBTBBGGBGGGGGGGGGGGTGGGGGGGGGGBGRT
BWWGGTGBBBGGGGBGGGGGGTBGGGTTGTTGGGGGBGTT
BRWGGGGRGGGGGGGGGGGGTTBTGTTTTTTTGGGRGGBG
GBWGTGGGGGGGTGGGGGGTTTTGGGGGTTTTRRGGTTRT
GBWTGGGGGGTTTGGGGGGTGTTGBGGGTTTGGGTTTRTT
TBWWWGGGGGGTTGGGGGGTTTTGTGGGTTGTTBRGTTGT
TGGGGWWWGGGGGGGGGBGGGGGGGGGGTGGGTTTTTTTT
TTGGGGWGGGGGGGRBBGGGTGGTTGGGGGRRGTTTTRGT
GGGGGGWWGGGGGGGGGGGGGGTTTGGGBBGGTRGGGTTT
BGGGGGGWWBGGGGGGGBGGTTTTTTGGBBBBGGGBGGTT
GGGGGGGWWWWWGGGGGTTGTTTTTTGTGGGGGGTGGTTT
GBGGGGGGGGGBWWRGRTTGGTTTTTGGBGGTGGGTTGGR
BGTGGTGGGBGRWWWRTRGTGTTTTGTGGGBGGGGTTGRT
GBTTGGGGGBBBBWWWRRTTTTBGGTTTGGGGBGGTBTTT