GGGBTTBGGGTBGGWWWWWWWWWWWWWWWWWWWGGBBGTGGBTTGBGGBB
GGBGGTBGGGGBBGGGWWWWWWWWWWWWWWGBRGGGBBTBGGGGGTTBGG
GGGGGGGGGGGGGGGGGGGWWWWWWWWWWWWGGGGGGGGGGGGGGGGGGG
GGGGGGGKGGGGGGGGGGWWGGGGWWWGGGWWGGGGGGKGGGGGGGGGGG
GGGGTTGGGGGGGWWWWWGGGGGGGGGGGGGWWGGGGGGGGGGGGGGGGG
GGGTTTGGGGGGGWGGGGGGGGGGGGGGGGGGWWWGGGGGGGGGGGGGGG
GGGTGGGGGGGGGWGGGGGGGGGGGGGGGGGGGGWWWGGGGGGGGGGGGG
GGGGGGBGGGGGWWGGGGGGGGGGGGGGGGGGGGGGWWGGGGGGGGGGGG
GGGGGGGBGGGWWGGGGGGGGGGGKGGGGGGGGGGGWWGGGGGGGGGGGG
GGGBBGGWGGWWGGGGGGGGGGGGRRGGGGGGGGGGWGGGGGGGGGGGGG
GGGGGGGWWWWGGGGGGGGGGGGRGGGGGGGGGGGGWWWGGWGGGGGGGG
GGGBGGGGGGWGGGGGGGGGGGGGGGGGGGGGGGGGGWWGWWGGGGGGGG
GGGGGGGGGGWGGGGGGGGGGGGGGGGGGGGGGGGGGGWWGGGGGGGGGG
GGGGGGGGGGWGGGGGGGGGGRRWGGGGGGGGGGGGGWWGGGGGGGGGGG
GGGGGGGGGGWGGGGGGGGGGGWWGGGGGGGGGGGGWWGGGGGGGGGGGG
GGGGGGGGGGWGGGGGGGGGGGGGGGGGGGWGGGGGWGGGGGGGGGGGGG
GGGGGGGGGGWWGGGGGGRGGGGGGGGGGRGGGGWGWGGGGGGGGGGGGG
GGGGGGGGGGGWWGGGGGGGGGGGGGGGGGGGGGGWWGGGGGGGGGGGGG
GGGGGGGGGGGGWGGGGGGGGGGGGGGGGGGGGGGWGGGGGGGGGGGGGG
GGGGGGGGGGGGWWGGGGGGGGGGGGGGGGGGGGGWGGGGGGGGGGGGGG
GGGGTTTGGGGGGWGGGGGGGGGGGGGGGGGWWWWWGGGGGGGGGGGGGG
GGGTGTGTGGGGGWGGGGGGGGGGGGGGGGGGGWGWWWGGGGGGGGGGGG
GGGTTTTTTGGGGWGGGGGGGGGGGGGGGGGGGGGGGWGGGGGGGGGGGG
GGGTBTGGBGGGGWWWWWGGGGGGGGGGGGGGGGGGGWGGGGGGGGGGGG
GGGBGGGGGGGGGGGGGWWWGGGGGGGGGGGGGGGGWWGGGGGGGGGGGG
TTGGGGGGGGGGGGGGGGWGGGGGGGGGGRGGGGGGWGGGGGGGGGGGGG
TTGGGGGGGGGGGGGGWWWGGGGGGGGGGGGGGGGGWWGGGGGGGGGGGG
tTTGGGGGGGGGGGGWWGGGGGGGGGGGGGGGGGGGGWGGGGGGGGGGGG
TTTGGGGGGGGGGWWWGGGGGGGGGGGGGGGGGGGGGWGGGGGGGTGGGG
TTTTGGGGGGGGWWGGGGGRGGGGGGGGGGGGGGGGGWWGGGGGBBTTGG
ttTTGGGGGGGGWGGGGGGGGGGGGGGtGGGGGGGGGGWGGGGGGGGTGG
tTTGGGGGGGGGWWGGGGGGGtGGGGGGGGGGGGGGGGWGGGGGGGGGGG
TTGGGGGGGGGGGWGWGGGGGGGGGGGGGGGGGGGGGWGGGGGGGGGGGG
TGGGGGGGGGGGGWWGGGGGGGGGGGGGGRGGGGGGWWGGGGGGGGGGTT
GGGGGGGGGGGGGGWGGGtGGGGRGGGGGGGGGGGGWGGGGGGGGGGTTT
GGGGGGGGGGGGGGWGGGtGGGGGGGGGttGGGWWWWGGGGGGGGGGTtt
GGGGGGGGGGGGGGWGGGGGGGtGGGGGBtGGGGGWGGGGGGGGGGGGTt
GGGGGGGGGGGGGGWGGGGGGGttGGGGGGGGGGGGWGGGGGGGGGGGGT
GGGGGGGGGGGGGWWGGGGGGGGGGGGtGGGRGGGGWGGGGGGGGGGGGT
GGGGGGGGGGGGGGWGGtGRGGGGGGGGGGGRGGGGWWGGGGGGGGGGGG
GGGGGGGGGGGGGGWGGGGGGGGGGGGGGGGGGGGWWGGGGGGGGGGGGG
GGGGGGGGGGGGGGWGGGGGGGGGGGGGGGGGWWWWGGGGGGGGGGGGGG
GGGGGGGGGGGGGGWWGGGGGGGWWWWGGGGWWGGGGGGGGGGGGGGGGG
GGGGGGGGGGGGGGGWWWGGGGWGGWWWWWWWGGGGGGGGGGGGGGGGGG
GGGGGGTGGGGGGGGGWWWWWWGGGGGGWWGWWGGGGGGGGGGGGGGGGG
GGGGGTTTGGGGGGGGGGGWGGGGPGGGGGGWWGGGGGGGGGGGGGGGGG
GGGGGTTTGGGGGGGGGGGWGGGGGGGGGGGGWWGGGGGGGGGGGGGGGG
GGGGGGTTGGGGGGGGGGWGGTBGSGGBGGGGWWGGGGGGGGGGGGGGGG
GGGGGGGGGGGGGGGGGWGGGGTGGGGGTTGGWWWWGGGGGGGGGGGGGG
GGGGGGGGGGGGGGGGGWWGGTGGGGGGGGGGGWWWWWGGGGGGGGGGGG