RGGWWTTGGGGTTGTTTTGGTGGTGTTTTGBGGTGT
GGGWWGTTTGTBGGGGGTTBGTTTTTRGTTRGTTBT
GRGWWRBGTTTGBBGGTTTGGGTGGGTGGBGGGTTG
GGRWWWGBTTRGBGGGGGGTGGGTTBGBGGGRGGTT
BBRGWWRGTTGRRRBGRTGGGGGGBBBBBGRGRGGG
GGGRGWWRRTGGTGBRTGGBGTGGGGBGBGBGGGBG
GRGRGRWGGRGGRRGRTTTGGTGGGGGGGGGGGGGB
GBGBRGWWRGGGGRRGGGTGTGGGGGGGGGGGGGGB
GGGGGGGWGTGGRGGTBGGGGGGGGGGGGGGGGGGG
GGGGGGGWRGGGGGBGGGGGRGGGGGGGGGGGGGRG
GGGGGGGWGGGGGGGGGGGGGGGGGGBGTGGGTGGG
GGGGGGWWGGGGGGGGGGBGGGGTGGGGTTGTGGBT
GGGGGWWGGGGGGGGGGGGBGGGGGGTTTTTTTTGG
GGGGGWWGGGGGGGGGGGBBGGGGTTTTTTTTTTTG
GGGGGWGGGGGGGGGGGRRGGGGTTTTTTGTTTTTG
GGGGGWGGGGGBGGGBGGGGGGGTTTTTTTTTTTGG
GTTGGWWGGBGGGGGGGGGGGGGTTTTTTTGGTTGB
GRTTGWWGGGGBGGGGGGGGGGGGTTBTTTGTTGBG
TTTRGTWWGBBTGTGGGGGBBGTGGGGGTTGBGTGG
TTTTTGWWRTTTGGGTGGGGBBGTGRRGGTGGGTTG
TTTTTRWWWRGTTTTGGBGGBBBGRGTGGGGBTGTT